000-------
0S0000----
000000000-
-000000000
-----00000
------0T0-