-----000---------
---00000000000---
---00--000---0---
---00--0-0---0---
0000-0000000000--
0-00-0---0--0-0--
0-0000T000--00000
000--0---000000-0
0000-0000S00----0
---0--0-0-0--0000
---0--0-000--0---
---00000000000---
------0--0--0----
------0000--0----
---------0000----