-----------------
-----------------
-----------------
-----------------
-----------------
-----------------
------000--------
------000--------
----0S00000------
------0-T--------
-----------------
-----------------
-----------------
-----------------
-----------------
