-----------------
----00000-------
----00-00-------
--0S00100-------
----00a003------
----00c0T-------
----0000--------