000-------
0S0000----
000000000-
-000000000
-----000T0
------000-