-----------------
-----------------
-----------------
-----------------
-----------------
------0-S--------
------0000-------
----000-00000000-
----000-0000-000-
------00000--000-
------0-000------
-----0000--------
-----0T0---------
-----------------
-----------------
